WWWWWWWWWWWWWWWWWWWWWWW.TTT..^^^^...WWWWWWWW
WWWWWWWWWWWWWWWWWWWWWW...T..^^^^....WWWWWWWW
WWWWWWWWWWWWWWWWWWWWWW......^^^......WWWWWWW
WWWWWWWWWWWWWWWWWWWWW..T.....^^^^..T.WWWWWWW
WWWWWWWWWWWWWWWWWWWWW........^^^^..T.WWWWWWW
WWWWWWWWWWWWWWWWWWWW........^^^....T.WWWWWWW
WWWWWWWWWWWWWWWWWWWW........^^^......WWWWWWW
WWWWWWWWWWWWWWWWWWWWWW.....^^^^.....WWWWWWWW
WWWWWWWWWWWWWWWWWWWWWW.....^^^......WWWWWWWW
WWWWWWWWWWWWWWWWWWWWWWW....^^......WWWWWWWWW
WWWWWWWWWWWWWWWWWWWWWW......^.....WWWWWWWWWW
WWWWWWWWWWWWWWWWWWWWW............WWWWWWWWWWW
WWWWWWWWWWWWWWWWWWWW....T......WWWWWWWWWWWWW
WWWWW...WWWWWWWWWWWWW..T.T.....WWWWWWWWWWWWW
WWWW..TTT.WWWWWWWWWWW...T.....WWWWWWWWWWWWWW
WWWWW.......WWWWWWWWWWW......WWWWWWWWWWWWWWW
WWWWWWWW..T..WWWWWWWWWWWWWWWWWWWWWWWWWWWWWWW
WWWWWWWWWT.T.WWWWWWWWWWWWWWWWWWWWWWWWWWWWWWW
WWWWWWWWW.T.WWWWWWWWWWWWWWWWWWWWWWWWWWWWWWWW
WWWWWWWWWWW.WWWWWWWWWW.....WWWWWWWWWWWWWWWWW
WWWWWWWWWWWWWWWWWWWWW....T................TW
WWWWWWWWWWWWWWWWWWWWWWW.T.T..............TTT
WWWWWWWWWWWWWWWWWWWWWWW..T................TW
WWWWWWWWWWWWWWWWWWWWWW...........WWWWWWWWWWW
WWWWWWWWWWWWWWWWWWWWWWWWWWWWWWWWWWWWWWWWWWWW
WWWWWWWWWWWWWWWWWWWWWWWWWWWWWWWWWWWWWWWWWWWW
WWWWWWWWWWWWWWWWWWWWWWWWWWWWWWWWWWWWWWWWWWWW
W: WATER                                    
T: TREE                                     
.: GRASS                                    
^: MOUNTAIN                                 
