WWWWWWWWWWWWWWWWWWWWWWW.TTT..^^^^...WWWWWWWW
WWWWWWWWWWWWWWWWWWWWWW...T..^^^^....WWWWWWWW
WWWWWWWWWWWWWWWWWWWWWW......^^^......WWWWWWW
WWWWWWWWWWWWWWWWWWWWW..T.....^^^^..T.WWWWWWW
WWWWWWWWWWWWWWWWWWWWW........^^^^..T.WWWWWWW
WWWWWWWWWWWWWWWWWWWW........^^^....T.WWWWWWW
WWWWWWWWWWWWWWWWWWWW........^^^......WWWWWWW
WWWWWWWWWWWWWWWWWWWWWW.....^^^^.....WWWWWWWW
WWWWWWWWWWWWWWWWWWWWWW.....^^^......WWWWWWWW
WWWWWWWWWWWWWWWWWWWWWWW....^^......WWWWWWWWW
WWWWWWWWWWWWWWWWWWWWWW......^.....WWWWWWWWWW
WWWWWWWWWWWWWWWWWWWWW............WWWWWWWWWWW
WWWWWWWWWWWWWWWWWWWW....T......WWWWWWWWWWWWW
WWWWW...WWWWWWWWWWWWW..T.T.....WWWWWWWWWWWWW
WWWW..TTT.WWWWWWWWWWW...T.....WWWWWWWWWWWWWW
WT.......WWWWWWWWWWW......WWWWWWWWWWWWWWWWWW
TTT...T...WWWWWWWWWWWWWWWWWWWWWWWWWWWWWWWWWW
WT...........WWWWWWWWWWWWWWWWWWWWWWWWWWWWWWW
WWWWWWWWWW.T.WWWWWWWWWWWWWWWWWWWWWWWWWWWWWWW
WWWWWWWWWWW.WWWWWWWWWW.....WWWWWWWWWWWWWWWWW
WWWWWWWWWWWWWWWWWWWWW....T..WWWWWWWWWWWWWWWW
WWWWWWWWWWWWWWWWWWWWWWW.T.T..WWWWWWWWWWWWWWW
WWWWWWWWWWWWWWWWWWWWWWW..T..WWWWWWWWWWWWWWWW
WWWWWWWWWWWWWWWWWWWWWW...WWWWWWWWWWWWWWWWWWW
WWWWWWWWWWWWWWWWWWWWWWWWWWWWWWWWWWWWWWWWWWWW
WWWWWWWWWWWWWWWWWWWWWWWWWWWWWWWWWWWWWWWWWWWW
WWWWWWWWWWWWWWWWWWWWWWWWWWWWWWWWWWWWWWWWWWWW
W: WATER                                    
T: TREE                                     
.: GRASS                                    
^: MOUNTAIN                                 
